XXXXXXXXXXXXXXXXXXXXXXXXXXXXXXXXXXXXXXXXXXXXXXXXXXXXXXXXXXXXXXXXXXXXXXXXXXXXXXXXXXXXXXXXXXXXXXXXXXXXX
P                   X   X               X   X                   X     X X         X   X         X   X
XXX XXXXXXXXXXXXXXX X X X XXXXX XXXXXXX X X X XXXXXXXXXXX XXXXX XXX X X X XXXXXXX X X XXXXX XXX X X X
X   X               X X X     X X     X X X   X   X     X   X X     X   X X     X   X       X X X X X
X XXX XXXXXXXXX XXXXX X XXXXX X X XXX X X XXXXXXX X XXX XXX X XXXXXXX XXX XXXXX XXXXXXXXXXXXX X XXX X
X   X     X   X       X X     X X X   X X   X     X X       X       X X   X     X       X     X   X X
X X XXXXX X X XXXXXXXXX XXXXXXX XXX XXX XXX X XXX X XXXXXXXXX XXXXXXX X XXX XXX X XXXXX X XXXXXXX X X
X X   X   X X     X   X         X   X   X X   X   X   X       X       X   X X X X   X X X X     X   X
XXXXX XXXXX XXXXX X X XXXXXXXXXXX XXX XXX X XXXXXXXXX X XXXXXXX XXXXXXXXX X X X XXX X X X X XXX XXX X
X     X     X   X X X     X         X X   X X     X   X X     X     X   X X X X     X     X X   X   X
X XXXXX XXXXX X X X XXXXX XXXXXXXXX X XXX X X XXX X XXX X XXX XXXXX X XXX X X XXXXXXX XXXXX X XXX XXX
X         X   X X   X   X         X     X   X X     X   X X X     X   X   X X         X     X X   X X
X XXXXXXXXX XXX X XXXXX XXXXXXXXX XXXXX XXX X XXXXXXX X X X XXX XXXXX X XXX XXXXXXXXXXX XXXXX X XXX X
X X   X     X X X     X         X     X   X X     X   X   X   X   X   X   X         X   X   X   X   X
X X XXX XXXXX X XXXXX XXXXX XXX XXXXX XXX XXXXXXX XXXXXXX XXX XXX X XXXXX X XXXXXXX X XXX X XXXXX X X
X   X   X     X     X       X   X   X   X X   X   X     X X   X X   X     X     X X X X   X       X X
XXXXX XXX X XXXXXXX XXX XXXXXXX X X XXX X X X X XXX XXX X X X X XXXXX X XXXXXXX X X X X XXXXX XXXXX X
X   X X   X       X X   X     X X X     X X X X       X X   X X   X   X X     X X X   X X   X X     X
X X X X XXXXX XXX X XXXXX XXX XXX X XXXXX X X XXXXXXXXX XXXXX X XXX XXXXX XXX X X XXXXXXX X X X XXXXX
X X   X X   X X   X     X X       X X   X   X           X   X X X   X   X X X X     X     X   X     X
X XXXXXXX X XXX XXXXXXX X X XXXXXXXXX X XXXXXXXXXXXXXXXXXXX X X X XXX X X X X XXXXX X XXXXXXXXXXXXX X
X         X   X X       X X X     X   X X   X               X   X   X X   X X     X   X     X       X
X XXXXXXXXXXX X X XXXXXXX XXX XXX X XXX X XXX XXXXX XXXXXXX X XXXXX X XXXXX XXXXX XXXXX XXX X XXXXXXX
X   X   X   X X X X             X X   X X         X X X     X X     X X         X X   X   X X   X   X
XXX X X X XXX X X XXXXXXXXXXXXXXX XXX X XXXXXXXXX X X X XXXXX X XXX X X X XXXXXXX X X X X X XXX X XXX
X     X   X   X X             X     X X         X X X X     X X   X X   X X       X X   X X X   X   X
X XXXXX XXX XXX XXXXXXXXXXXXX X XXXXX XXXXXXXXX X X X XXX XXX XXX XXX XXXXX XXXXXXX XXXXX XXX XXX X X
X X   X X   X       X     X   X       X   X   X X X X   X X   X X     X   X X     X X   X X   X   X X
XXX X X X XXX XXXXX X XXX X XXXXXXXXXXX X X X X XXX X XXX X XXX XXXXXXX X X XXX XXX X XXX X XXXXXXX X
X   X X X X X     X X   X X X     X     X   X   X   X     X X         X X X X   X     X   X   X   X X
X XXX X X X X XXX XXXXX X X X XXX X XXXXXXXXXXXXX XXXXX XXX X XXXXXXXXX X X X XXX XXXXX X XXX X X X X
X X   X X X   X X       X   X X X   X         X X     X   X X X   X     X X X     X X   X   X X X   X
X X XXXXX X XXX XXXXXXXXXXXXX X XXXXXXX XXXXX X X XXX XXXXX X X X X XXXXX X XXXXX X X XXXXXXX X XXX X
X X     X X   X             X X         X       X   X     X X   X X   X X X X   X   X       X   X   X
X XXXXX X XXX X XXXXXXXXXXX X X XXXXX XXX XXXXXXX XXXXX X X XXXXX XXX X X X X X XXXXX XXXXX XXXXX XXX
X   X X   X   X X     X   X   X X   X X X   X     X   X X X       X   X X X   X     X   X X     X X X
X X X XXXXX XXX X XXX X X XXXXX X XXX X XXX X XXXXX X XXX XXXXXXX X XXX X X XXXXXXX XXX X X XXX X X X
X X X   X       X   X   X X       X   X     X   X X X     X     X X X   X X     X   X X   X X   X   X
X X XXX X XXXXXXXXX XXXXX X XXXXXXX XXX XXXXXXX X X XXXXX XXX XXX X XXX X XXXXXXX XXX XXX X XXXXXXX X
X X   X X   X   X   X   X X     X   X   X     X   X X   X   X X   X   X       X   X     X X         X
X XXX X X XXX X X XXXXX X XXX XXX XXX XXX XXXXXXX X XXX XXX X X XXXXX XXXXXXX X XXX X XXX XXXXXXXXX X
X X   X   X   X         X   X X   X       X       X   X   X   X X   X   X   X X X X X     X X     X X
X X XXXXXXX XXXXXXXXXXXXXXX X X XXXXXXXXX X XXXXXXXXX XXX XXX X X X XXX XXX X X X X XXXXXXX X XXX X X
X X     X   X   X           X X         X X X       X   X     X   X   X   X     X       X   X X   X X
X XXXXX X XXX X X XXXXXXXXXXXXXXX XXXXX X X X X XXXXXXX XXX XXXXXXXXX XXX X XXXXXXXXXXX X XXX X XXX X
X   X X X X X X   X     X       X X     X X X X X     X   X X     X     X X   X     X     X   X X   X
XXX X X X X X XXXXX X XXX XXX X X X XXXXXXX X XXX XXX XXX XXX X XXX XXXXX XXX X XXX XXXXXXX XXX XXX X
X X X X     X   X   X   X X X X X X     X   X   X   X   X     X   X X X   X   X X X     X   X X   X X
X X X XXXXXXXXX X XXXXX X X X X XXXXXXX X XXX X X XXXXX XXXXXXXXX X X X XXX XXX X XXXXX X XXX XXX X X
X X X   X   X   X X     X X X X     X   X X   X   X   X         X     X X X   X   X   X   X   X   X X
X X X XXX X X XXXXX XXX X X X XXXXX X X X XXXXXXXXX X XXXXXXX X XXXXXXX X XXX XXX X XXXXXXXXX X XXX X
X   X X   X   X     X   X   X X       X X       X   X         X     X   X   X X X X           X X X X
X XXX X XXXXXXX X XXXXX XXX X XXXXXXXXXXXXXXXXX X X XXXXXXXXXXXXXXX X XXX X X X X X X XXXXXXX X X X X
X   X X   X   X X     X X X X         X     X   X X X           X   X   X X     X X X X       X X X X
XXX X XXX X X X XXXXX X X X XXXXXXXXX X XXX X XXX XXX XXXXXXXXX X XXXXX X XXXXXXX XXX X XXXXXXX X X X
X       X X X X     X X   X X     X X X X X X   X   X   X   X   X     X X   X X   X   X X       X   X
XXXXXXX X X X XXXXX X XXX X X X X X X X X X XXX X X X XXX X X X XXXXXXX XXX X X XXX X XXX XXXXXXX XXX
X     X X X X     X X   X X X X X   X X X X     X X   X   X   X X       X     X   X X X   X     X X X
X XXX XXX XXXXX X X XXX X X XXX X XXX X X XXXXXXXXXXX X XXXXXXX X XXXXXXX XXXXXXX X XXX XXX X XXX X X
X X     X X     X X X   X X   X X X   X X     X     X X X   X   X   X X     X       X   X X X X   X X
X XXXXX X X XXXXXXX X XXXXXXX X XXX X X X XXX X XXX XXX X X X XXXXX X X XXXXX XXXXXXX XXX X X X XXX X
X X   X X X         X X     X X   X X X   X   X   X     X X     X   X   X     X X     X   X X   X   X
X X X X X X XXXXX XXX X XXX X XXX X XXXXXXX XXXXX XXXXXXX XXXXX X XXXXX X XXXXX X XXXXX X X XXXXXXX X
X X X X   X X   X   X X   X X     X X             X       X   X X     X X X     X X     X X   X     X
X X X XXXXX X X XXX X XXX X XXXXX X X XXXXXXXXXXXXX XXXXXXX X XXX XXX X X XXX X X X XXXXXXXXX X XXX X
X   X     X X X X   X   X X     X X   X X   X   X         X X   X X   X X X   X X X X       X X X   X
X XXXXXXX XXX X XXXXX XXX XXXXX X XXXXX X X X X X XXXXXXXXX XXX XXX XXX X X XXXXXXX X XXXXX X X XXXXX
X X     X     X   X   X   X     X X     X X X X X X       X   X     X   X X         X   X X   X     X
X X XXX XXXXXXXXX X XXX XXX XXXXX X XXX X X X X XXX XXXXX XXX XXXXXXXXXXX X XXX X XXXXX X XXXXX XXX X
X   X X X X       X X     X     X X X   X X   X       X     X             X   X X X   X   X   X X   X
XXXXX X X X XXXXXXX X XXXXXXX X X XXX X X XXXXXXXXXXXXX XXXXXXXXXXXXXXXXXXX XXX XXX X XXX X X X X X X
X   X   X X   X       X     X X X     X X     X X   X   X           X X     X   X   X   X X X X X X X
XXX X XXX XXX XXXXXXXXX XXX X X XXXXXXX XXXXX X X X X XXX XXXXXXX X X X XXXXX XXX XXXXX X X XXX X X X
X   X       X   X       X X X X   X   X     X X X X X         X   X X X X   X   X   X X   X   X X X X
X X XXXXX XXXXX X XXXXXXX X X XXX X X XXXXX X X X X XXXXXXXXXXX XXX X X X XXXXX XXX X XXXXX X X X XXX
X X X X   X   X X       X X X   X   X       X X   X   X X   X   X X   X X     X     X     X X X X   X
X X X X XXX X X XXXXXXX X X XXXXXXXXXXXXXXXXX XXXXX X X X X X XXX XXX X XXXXX XXXXXXXXXXX X X X XXX X
X X   X X X X     X     X X X               X   X   X   X X   X       X X   X             X X     X X
X XXXXX X X XXXXXXX XXXXX X X XXXXXXXXXXXXX XXX X XXXXX X XXX XXXXXXX X X X X XXX X XXXXXXX XXXXXXX X
X X     X X     X   X     X   X     X     X   X   X     X X   X     X X X X X   X X X     X X   X   X
X X XXXXX XXXXX X XXX X XXXXXXX XXX XXX X XXX XXXXX XXXXX XXXXX XXX XXX X X XXXXX X X XXX X X X X X X
X X   X   X   X X X   X         X X   X X   X X     X   X X   X X   X   X X     X X X   X     X X X X
X XXX X X X X X X XXX XXX XXXXXXX XXX XXXXX X X XXXXX XXX X X X X X X XXX XXXXX X X XXX XXXXXXXXX X X
X   X   X X X X X   X X X X         X X     X X X X     X   X   X X X X   X       X X X X       X X X
X X XXXXX XXX X XXX X X X X XXXXXXX X X XXXXX X X X XXX XXXXXXXXX XXX X XXXXXXXXXXX X X X XXXXX X X X
X X     X   X X   X X X X X X     X   X     X   X     X X         X   X       X       X X   X X   X X
X XXX XXXXX X X XXX X X X X XXX XXXXXXX XXX XXXXX XXXXX X XXXXX XXX XXX XXXXX XXXXXXXXX XXX X XXXXX X
X X X     X   X X   X X X X   X     X X X       X X     X X   X X   X X     X           X X X   X   X
X X XXX XXX XXX X XXX X X XXX XXX X X X X XXXXX XXX XXX X X X XXX XXX XXXXX XXXXXXXXXXXXX X X X X XXX
X X X   X   X   X X X   X   X     X X   X X   X   X   X X X X     X       X X       X     X X X     X
X X X XXX XXX X X X XXX XXX XXXXXXX XXXXX X X XXX XXX XXX X XXXXXXX XXX X X XXXXX X XXX X X XXXXXXX X
X   X X   X   X X X   X   X   X           X X X       X   X X   X     X X X       X     X X       X X
XXXXX X XXX X XXX X X XXX XXX XXXXXXXXXXXXX X X XXXXXXX XXX X X XXXXXXX XXXXXXXXXXX XXXXX XXXXXXX X X
X     X X   X X   X X       X X       X     X X X   X   X   X X       X             X   X   X     X X
X XXXXX X XXX X XXXXXXXXXXXXX X XXXXX X XXXXX XXX X X XXX XXX XXXXXXX XXXXXXXXXXX XXX X XXXXX XXXXX X
X     X X X   X   X     X   X     X   X     X     X X   X X     X   X X   X     X   X X       X   X X
X XXX X X XXXXXXX X XXX X X XXXXXXX XXXXX XXXXXXXXX XXX X X XXX X X X X X X XXX XXXXX XXXXXXXXX X X X
X X   X X       X X X X   X       X       X         X X X X X   X X   X X   X X X   X     X X   X   X
X X XXX XXXXXXX X X X XXXXXXXXXXX XXXXXXXXX XXXXXXX X X X XXX XXX XXXXX XXXXX X X X XXXXX X X XXXXXXX
X X           X     X                       X         X       X         X         X       X         K
XXXXXXXXXXXXXXXXXXXXXXXXXXXXXXXXXXXXXXXXXXXXXXXXXXXXXXXXXXXXXXXXXXXXXXXXXXXXXXXXXXXXXXXXXXXXXXXXXXXXX
