XXXXXXX
P     X
X XXXXX
X X   X
X XXX X
X     K
XXXXXXX
