XXXXXXXXXXXXXXXXXXXXXXXXXXXXXXXXXXXXXXXXXXXXXXXXX
P X           X                       X         X
X X X XXXXXXXXX X XXXXXXXXXXXXX XXXXX XXXXX XXXXX
X X X   X     X X       X X     X   X X   X     X
X X XXX X XXX X XXXXXXX X X XXXXX X X X X XXXXX X
X X X X   X X X     X   X   X   X X X   X       X
X X X XXXXX X XXXXX X X XXXXX X X X XXXXXXXXXXX X
X X X       X   X   X X X   X X   X X X   X   X X
X X X XXXXX X XXX XXX XXX X X XXXXX X X X X X X X
X X X   X   X X   X X     X X X X   X   X   X   X
X X XXX X XXX X XXX XXXXXXX X X X XXX XXXXXXX XXX
X X X   X X   X X         X X X X   X   X   X   X
X X X XXXXX XXX X XXXXXXX X X X XXX XXXXX X XXX X
X   X     X     X   X X   X   X   X       X   X X
X XXXXX X XXXXXXXXX X X XXXXXXXXX XXXXXXXXXXX XXX
X     X X           X X   X             X   X   X
XXXXX X XXX XXXXXXXXX XXX XXX XXXXXXXXX X XXXXX X
X   X X   X   X         X     X   X     X     X X
XXX X XXX XXX XXXXXXX XXXXXXX X X X XXXXXXX XXX X
X   X   X   X       X   X     X X X X       X   X
X XXXXX X XXXXX XXX X X X XXXXX X X XXX XXX X XXX
X     X X X   X   X X X     X   X X   X   X X   X
XXX X X XXX X XXXXX XXXXXXXXX XXX XXX XXX X XXX X
X   X X   X X   X   X           X X       X   X X
X XXX XXX X XXX X XXX XXXXXXXXXXX XXXXX XXXXX X X
X   X   X X   X X     X   X   X   X   X X   X X X
X X XXX X XXX X X XXXXX X XXX X XXX X XXX X XXX X
X X   X X     X X   X   X     X   X X     X     X
X XXX XXXXXXXXX XXX X XXXXXXX XXX X XXXXXXXXXXX X
X   X     X   X X X X X     X   X X       X     X
XXX XXXXX X X X X X X X XXX XXXXX XXXXXXX X XXXXX
X   X   X   X   X X   X X           X X   X     X
X XXXXX XXXXXXXXX XXX X X XXXXXXXXX X X XXXXXXX X
X     X       X       X X X     X     X X       X
XXXXX XXX XXX X XXXXXXX X X XXX XXXXXXX X XXXXXXX
X   X X   X X X     X X X X   X       X X   X   X
X XXX X XXX X XXXXX X X X XXX XXXXXXX X XXX X X X
X     X   X   X       X X   X X         X X X X X
X XXXXX X XXX X XXXXX X XXXXX XXXXXXXXXXX X X X X
X X     X   X X X   X X     X     X   X   X   X X
X XXXXXXXXX XXX X X XXXXXXX XXXXX X X X XXXXXXX X
X X   X   X     X X X       X   X   X X     X   X
X X X X X XXXXXXX X X XXXXX X XXXXXXX X XXX X XXX
X X X   X   X     X   X   X X X       X   X X X X
X X XXXXXXX X XXXXXXXXX X X X X XXXXXXX XXX X X X
X   X   X   X X     X   X X X X   X   X X X X   X
XXXXX XXX XXX X XXX X X XXX X XXX X X XXX X XXX X
X             X   X   X         X   X     X     K
XXXXXXXXXXXXXXXXXXXXXXXXXXXXXXXXXXXXXXXXXXXXXXXXX
