XXXXXXXXXXX
P         X
X XXXXXXX X
X       X X
X XXXXX XXX
X X   X   X
X XXX X X X
X   X X X X
XXX X XXX X
X   X     K
XXXXXXXXXXX
